|#****########****#|
|                  |
|                  |
|S?              ?S|
|                  |
|##   S?    ?S   ##|
|                  |
|                  |
|    ##########    |
|                  |
|                  |
|  ?            ?  |
|     S      S     |
|X                X|
|=~~~==========~~~=|

