##******####******##
|  S            S  |
|?                ?|
| ###          ### |
| #              # |
| #    S ?? S    # |
|                  |
|?   ####  ####   ?|
|                  |
| #              # |
| #X            X# |
| ###          ### |
|     ?  SS  ?     |
|X                X|
=====~~~####~~~=====
