|***#***#####***#**|
|   #     ?     #  |
|   # ?       ? #  |
| ?               ?|
|                  |
|                  |
|                  |
|         S        |
|         X        |
|     S   #   S    |
|     X   #   X    |
| S   #   #   #   S|
| X   #   #   #   X|
| #   #   #   #   #|
|~#~~~#~~~#~~~#~~~#|
