|****####**####****|
|                  |
|   ?    SS    ?   |
|                  |
|  ==    ==    ==  |
|                  |
|     S      S     |
|  ?            ?  |
|     == ?? ==     |
|                  |
|  S            S  |
|   X    XX    X   |
|  ==    ==    ==  |
|                  |
|~~~~~~~~~~~~~~~~~~|

