|##################|
|                  |
|                  |
|                  |
|                  |
|                  |
|                  |
|        SS        |
|                  |
|     S  ##  S     |
|        ||        |
|  S  #  ||  #  S  |
|     |  ||  |     |
|  #  |  ||  |  #  |
|~~|~~|~~||~~|~~|~~|
